7053 1080
4 2351
22 23 24 25
30 100
11 -1 -1 -1 -1 -1 -1 -1 -1 -1 -1 -1 -1 -1 -1 -1 -1 -1 -1 -1 -1 -1 -1 -1 -1 -1 -1 -1 -1 -1 -1 -1 -1 -1 -1 -1 -1 -1 -1 -1 -1 -1 -1 -1 -1 -1 -1 -1 -1 -1 -1 -1 -1 -1 -1 -1 -1 -1 -1 -1 -1 -1 -1 -1 -1 -1 -1 11 -1 -1 11 -1 -1 -1 -1 -1 -1 -1 -1 -1 -1 -1 -1 11 -1 -1 -1 14 12 -1 -1 -1 -1 -1 -1 -1 14 8 8 7 
6 -1 -1 -1 -1 -1 -1 -1 -1 -1 -1 -1 -1 -1 -1 -1 -1 -1 -1 -1 -1 -1 -1 -1 -1 -1 -1 -1 -1 -1 -1 -1 -1 -1 -1 -1 -1 -1 -1 -1 -1 -1 -1 -1 -1 -1 -1 -1 -1 -1 -1 -1 -1 -1 -1 -1 -1 -1 -1 -1 -1 -1 -1 -1 -1 -1 -1 6 -1 -1 6 -1 -1 -1 -1 -1 -1 -1 -1 -1 -1 -1 -1 6 -1 -1 -1 -1 -1 -1 -1 -1 -1 -1 -1 -1 -1 -1 -1 6 
6 -1 -1 -1 -1 -1 -1 -1 -1 -1 -1 -1 -1 -1 -1 -1 -1 -1 -1 -1 -1 -1 -1 -1 -1 -1 -1 -1 -1 -1 -1 -1 -1 -1 -1 -1 -1 -1 -1 -1 -1 -1 -1 -1 -1 -1 -1 -1 -1 -1 -1 -1 -1 -1 -1 -1 -1 -1 -1 -1 -1 -1 -1 -1 -1 -1 -1 10 2 2 9 -1 -1 -1 -1 -1 -1 -1 -1 -1 -1 -1 -1 1 8 12 -1 -1 -1 -1 -1 -1 -1 -1 -1 -1 -1 14 8 3 
6 -1 -1 14 8 8 8 8 8 8 8 8 8 8 8 8 8 8 8 8 8 8 8 8 8 8 8 8 8 8 8 8 8 8 7 -1 -1 -1 -1 -1 -1 -1 -1 -1 -1 -1 -1 -1 -1 -1 -1 -1 -1 -1 -1 -1 -1 -1 -1 -1 -1 -1 -1 -1 -1 -1 -1 -1 1 3 -1 -1 -1 -1 -1 5 8 8 8 8 8 12 -1 6 -1 -1 -1 15 -1 -1 -1 -1 -1 -1 -1 15 -1 -1 -1 6 
1 12 -1 -1 -1 -1 -1 -1 -1 -1 -1 -1 -1 -1 -1 -1 -1 -1 -1 -1 -1 -1 -1 -1 -1 -1 -1 -1 -1 -1 -1 -1 -1 -1 6 -1 -1 -1 -1 -1 -1 -1 -1 -1 -1 -1 -1 -1 -1 -1 -1 -1 -1 -1 -1 -1 -1 -1 -1 -1 -1 -1 -1 -1 -1 -1 -1 -1 1 3 -1 -1 -1 -1 -1 6 -1 -1 -1 -1 -1 -1 -1 1 8 12 -1 -1 -1 -1 -1 -1 -1 -1 -1 -1 -1 14 8 3 
6 -1 -1 14 8 8 2 8 8 8 8 8 8 8 8 8 8 8 8 8 8 8 8 8 8 8 8 8 8 12 -1 -1 -1 -1 10 8 8 8 8 2 2 2 2 2 8 8 8 12 -1 -1 -1 -1 -1 -1 -1 -1 -1 -1 -1 -1 -1 -1 -1 -1 -1 -1 -1 -1 1 3 -1 -1 -1 -1 5 9 -1 -1 -1 -1 -1 -1 -1 6 -1 -1 -1 -1 -1 -1 -1 -1 -1 -1 -1 -1 -1 -1 -1 6 
6 -1 -1 -1 -1 -1 6 -1 -1 -1 -1 -1 -1 -1 -1 -1 -1 -1 -1 -1 -1 -1 -1 -1 -1 -1 -1 -1 -1 -1 -1 -1 -1 -1 -1 -1 -1 -1 -1 1 0 4 4 9 -1 -1 -1 -1 -1 -1 -1 -1 -1 -1 -1 -1 -1 -1 -1 -1 -1 -1 -1 -1 -1 -1 -1 -1 1 3 -1 -1 -1 -1 6 -1 -1 -1 -1 -1 -1 -1 -1 6 -1 14 8 8 8 8 8 8 8 8 8 8 8 8 8 3 
6 -1 -1 -1 -1 -1 6 -1 -1 -1 -1 -1 -1 -1 -1 -1 -1 -1 -1 -1 -1 -1 -1 -1 -1 -1 -1 -1 -1 -1 -1 14 8 8 12 -1 -1 -1 -1 1 3 -1 -1 -1 -1 -1 -1 -1 -1 -1 5 2 2 2 2 2 2 2 2 7 -1 -1 -1 -1 -1 -1 -1 -1 1 3 -1 14 2 8 9 -1 -1 14 8 8 8 8 8 3 -1 -1 -1 -1 -1 -1 -1 -1 -1 -1 -1 -1 -1 -1 -1 6 
1 8 12 -1 -1 -1 6 -1 -1 -1 -1 -1 -1 -1 -1 -1 -1 -1 -1 -1 -1 -1 -1 -1 -1 -1 -1 -1 -1 -1 -1 -1 -1 -1 -1 -1 -1 -1 -1 1 3 -1 -1 -1 -1 -1 -1 15 -1 -1 10 0 0 0 0 0 0 0 0 9 -1 -1 -1 -1 -1 -1 -1 -1 1 3 -1 -1 6 -1 -1 -1 -1 -1 -1 -1 -1 -1 -1 1 7 -1 -1 -1 -1 -1 -1 -1 -1 -1 -1 -1 -1 -1 -1 6 
6 -1 -1 -1 -1 -1 6 -1 -1 -1 -1 -1 -1 -1 -1 -1 -1 -1 -1 -1 -1 -1 -1 -1 -1 -1 14 8 8 12 -1 -1 -1 -1 -1 -1 -1 -1 -1 1 3 -1 -1 -1 15 -1 -1 -1 -1 -1 -1 10 0 4 4 4 4 4 9 -1 -1 -1 -1 -1 -1 -1 -1 -1 1 0 12 -1 6 -1 -1 -1 -1 -1 -1 -1 -1 -1 -1 1 0 7 -1 -1 -1 -1 -1 -1 -1 -1 -1 -1 -1 -1 -1 6 
6 -1 -1 -1 -1 -1 6 -1 -1 -1 -1 -1 -1 -1 -1 -1 -1 -1 -1 -1 -1 -1 -1 -1 -1 -1 -1 -1 -1 -1 -1 -1 -1 -1 -1 -1 -1 -1 -1 1 0 7 -1 -1 -1 -1 -1 -1 -1 -1 -1 -1 6 -1 -1 -1 -1 -1 -1 -1 -1 5 2 2 2 2 2 2 0 3 -1 -1 6 -1 -1 -1 -1 -1 -1 -1 -1 -1 -1 10 4 4 8 8 8 8 8 8 8 8 2 2 8 12 -1 6 
6 -1 -1 14 12 -1 6 -1 -1 -1 -1 -1 -1 -1 -1 -1 -1 -1 -1 -1 -1 14 8 8 12 -1 -1 -1 -1 -1 -1 -1 -1 -1 -1 -1 -1 -1 -1 1 0 0 7 -1 -1 -1 -1 -1 -1 -1 -1 -1 6 -1 -1 -1 -1 -1 -1 -1 -1 10 4 4 4 4 4 4 0 3 -1 14 4 8 8 8 8 8 8 8 2 7 -1 -1 -1 -1 -1 -1 -1 -1 -1 -1 -1 -1 1 3 -1 -1 -1 6 
6 -1 -1 -1 -1 -1 6 -1 -1 -1 -1 -1 -1 -1 -1 -1 -1 -1 -1 -1 -1 -1 -1 -1 -1 -1 -1 -1 -1 -1 -1 -1 -1 -1 -1 -1 -1 -1 -1 1 0 0 0 2 2 2 2 2 2 2 2 2 3 -1 -1 -1 -1 -1 -1 -1 -1 -1 -1 -1 -1 -1 -1 -1 1 3 -1 -1 -1 -1 -1 -1 -1 -1 -1 -1 10 4 7 -1 -1 -1 -1 -1 -1 -1 -1 -1 -1 -1 1 3 -1 -1 14 3 
6 -1 -1 -1 -1 -1 6 -1 -1 -1 -1 -1 -1 -1 -1 -1 14 8 8 12 -1 -1 -1 -1 -1 -1 -1 -1 -1 -1 -1 -1 -1 -1 -1 -1 -1 -1 -1 1 0 4 4 4 4 4 4 4 4 4 4 4 4 8 8 8 8 8 8 7 -1 -1 -1 -1 -1 -1 -1 -1 1 0 8 8 8 8 8 8 8 12 -1 -1 -1 -1 10 7 -1 -1 -1 -1 -1 -1 -1 -1 -1 -1 1 0 12 -1 -1 6 
1 8 12 -1 -1 -1 6 -1 -1 -1 -1 -1 -1 -1 -1 -1 -1 -1 -1 -1 -1 -1 -1 -1 -1 -1 -1 -1 -1 -1 -1 -1 -1 -1 -1 -1 -1 -1 -1 1 3 -1 -1 -1 -1 -1 -1 -1 -1 -1 -1 -1 -1 -1 -1 -1 -1 -1 -1 10 8 8 8 8 8 8 12 -1 1 3 -1 -1 -1 -1 -1 -1 -1 -1 -1 -1 -1 -1 -1 1 2 7 -1 -1 -1 -1 -1 -1 -1 -1 1 3 -1 -1 -1 6 
6 -1 -1 -1 -1 -1 6 -1 -1 -1 -1 14 8 8 12 -1 -1 -1 -1 -1 -1 -1 -1 -1 -1 -1 -1 -1 -1 -1 -1 -1 -1 -1 -1 -1 -1 -1 -1 1 3 -1 -1 -1 -1 -1 -1 -1 -1 -1 -1 -1 -1 -1 -1 -1 -1 -1 -1 -1 -1 -1 -1 -1 -1 -1 -1 -1 1 3 -1 -1 -1 14 8 8 8 8 8 8 8 8 8 0 0 0 8 8 8 8 8 12 -1 -1 1 3 -1 -1 14 3 
6 -1 -1 -1 -1 -1 6 -1 -1 -1 15 -1 -1 -1 -1 -1 -1 -1 -1 -1 -1 -1 -1 -1 -1 -1 -1 -1 -1 -1 -1 -1 -1 -1 -1 -1 -1 -1 -1 1 9 -1 -1 -1 -1 -1 -1 -1 -1 -1 -1 -1 -1 -1 -1 -1 -1 -1 -1 5 8 8 8 8 8 8 8 8 4 3 -1 -1 -1 -1 -1 -1 -1 -1 -1 -1 -1 -1 -1 1 0 3 -1 -1 -1 -1 -1 -1 -1 -1 1 3 -1 -1 -1 6 
6 -1 -1 14 12 -1 6 -1 -1 -1 -1 -1 -1 -1 -1 -1 -1 -1 -1 -1 -1 -1 -1 -1 -1 -1 -1 -1 -1 -1 -1 -1 -1 -1 -1 -1 -1 -1 -1 6 -1 -1 -1 -1 -1 -1 -1 -1 -1 -1 -1 -1 -1 -1 -1 -1 -1 -1 -1 6 -1 -1 -1 -1 -1 -1 -1 -1 -1 1 8 12 -1 -1 -1 -1 -1 -1 -1 -1 -1 -1 -1 1 0 3 -1 -1 -1 -1 -1 -1 -1 -1 1 0 12 -1 -1 6 
6 -1 -1 -1 -1 -1 1 8 8 8 8 12 -1 -1 -1 -1 -1 -1 -1 -1 -1 -1 -1 -1 -1 -1 -1 -1 -1 -1 -1 -1 -1 -1 -1 -1 -1 -1 -1 1 7 -1 -1 -1 5 2 2 2 2 2 2 2 2 2 2 2 2 2 2 3 -1 -1 -1 -1 -1 -1 -1 -1 -1 6 -1 -1 -1 -1 15 -1 -1 -1 15 -1 -1 -1 -1 1 0 3 -1 -1 5 2 2 2 2 2 0 3 -1 -1 -1 6 
6 -1 -1 -1 -1 -1 6 -1 -1 -1 -1 -1 -1 14 8 12 -1 -1 -1 -1 -1 -1 -1 -1 -1 -1 -1 -1 -1 -1 -1 -1 -1 -1 -1 -1 -1 -1 -1 1 3 -1 -1 -1 10 4 4 4 4 4 4 4 4 4 4 4 4 4 4 9 -1 -1 -1 -1 -1 -1 -1 -1 -1 6 -1 -1 -1 15 -1 15 -1 15 -1 15 -1 -1 -1 1 0 3 -1 -1 1 0 0 0 0 0 0 3 -1 -1 14 3 
1 8 12 -1 -1 -1 6 -1 -1 -1 -1 -1 -1 -1 -1 -1 -1 -1 14 12 -1 -1 -1 -1 -1 -1 -1 -1 -1 -1 -1 -1 -1 -1 -1 -1 -1 -1 -1 1 3 -1 -1 -1 -1 -1 -1 -1 -1 -1 -1 -1 -1 -1 -1 -1 -1 -1 -1 -1 -1 -1 -1 14 8 8 8 8 8 9 -1 -1 15 -1 -1 -1 15 -1 -1 -1 15 -1 -1 1 0 3 -1 14 4 4 0 0 0 0 0 3 -1 -1 -1 6 
6 -1 -1 -1 14 8 9 -1 -1 -1 -1 -1 -1 -1 -1 -1 -1 -1 -1 -1 -1 -1 -1 -1 -1 -1 -1 -1 -1 -1 -1 -1 -1 -1 -1 -1 -1 5 8 4 4 8 7 -1 -1 -1 -1 -1 -1 -1 -1 -1 -1 -1 -1 -1 -1 -1 -1 -1 -1 -1 -1 -1 -1 -1 -1 -1 -1 -1 -1 -1 -1 15 -1 -1 -1 -1 -1 15 -1 -1 -1 1 4 3 -1 -1 -1 -1 10 4 4 4 4 4 12 -1 -1 6 
6 -1 -1 -1 -1 -1 -1 -1 -1 -1 -1 -1 -1 -1 -1 -1 14 8 12 -1 -1 -1 -1 -1 -1 -1 -1 -1 -1 -1 -1 -1 -1 -1 -1 -1 5 9 -1 -1 -1 -1 10 7 -1 -1 -1 -1 -1 -1 -1 -1 -1 -1 -1 -1 5 2 8 8 8 2 7 -1 -1 -1 -1 -1 -1 -1 -1 -1 -1 -1 15 -1 -1 -1 15 -1 -1 -1 5 9 -1 10 7 -1 -1 -1 -1 -1 -1 -1 -1 -1 -1 -1 -1 6 
6 -1 -1 -1 -1 -1 -1 -1 -1 -1 -1 -1 14 8 12 -1 -1 -1 -1 -1 -1 -1 -1 -1 -1 -1 -1 -1 -1 -1 -1 -1 -1 -1 -1 5 9 -1 -1 -1 -1 -1 -1 10 7 -1 -1 -1 -1 -1 -1 -1 -1 -1 -1 5 4 9 -1 -1 -1 10 4 7 -1 -1 -1 -1 -1 -1 -1 -1 -1 -1 -1 15 -1 15 -1 -1 -1 5 9 -1 -1 -1 10 7 -1 -1 -1 -1 -1 -1 -1 -1 -1 -1 5 3 
6 -1 -1 -1 -1 -1 -1 -1 -1 -1 -1 -1 -1 -1 -1 -1 -1 -1 -1 -1 -1 -1 -1 -1 -1 -1 -1 -1 -1 -1 -1 -1 -1 -1 5 3 -1 -1 -1 -1 -1 -1 -1 -1 1 7 -1 -1 -1 -1 -1 -1 -1 -1 5 3 -1 -1 -1 -1 -1 -1 -1 1 7 -1 -1 -1 -1 -1 -1 -1 -1 -1 -1 -1 -1 -1 -1 -1 5 3 -1 -1 -1 -1 -1 1 7 -1 -1 -1 -1 -1 -1 -1 -1 -1 1 3 
1 2 2 2 2 2 8 8 8 8 8 8 2 2 2 2 2 2 2 2 2 2 2 2 2 2 2 2 2 2 2 2 2 2 0 0 2 2 2 2 2 2 2 2 0 0 2 2 2 2 2 2 2 2 0 0 2 2 2 2 2 2 2 0 0 2 2 2 2 2 2 2 2 2 2 2 2 2 2 2 0 0 2 2 2 2 2 0 0 2 2 2 2 2 2 2 2 2 0 3 
1 0 0 0 0 3 -1 -1 -1 -1 -1 -1 10 0 0 0 0 0 0 0 0 0 0 0 0 0 0 0 0 0 0 0 0 0 0 0 0 0 0 0 0 0 0 0 0 0 0 0 0 0 0 0 0 0 0 0 0 0 0 0 0 0 0 0 0 0 0 0 0 0 0 0 0 0 0 0 0 0 0 0 0 0 0 0 0 0 0 0 0 0 0 0 0 0 0 0 0 0 0 3 
10 4 4 4 4 9 -1 -1 -1 -1 -1 -1 -1 10 4 4 4 4 4 4 4 4 4 4 4 4 4 4 4 4 4 4 4 4 4 4 4 4 4 4 4 4 4 4 4 4 4 4 4 4 4 4 4 4 4 4 4 4 4 4 4 4 4 4 4 4 4 0 0 0 0 4 4 4 4 4 4 4 4 4 4 4 4 4 4 4 4 4 4 4 4 4 4 4 4 4 4 4 4 9 
-1 -1 -1 -1 -1 -1 -1 -1 -1 -1 -1 -1 -1 -1 -1 -1 -1 -1 -1 -1 -1 -1 -1 -1 -1 -1 -1 -1 -1 -1 -1 -1 -1 -1 -1 -1 -1 -1 -1 -1 -1 -1 -1 -1 -1 -1 -1 -1 -1 -1 -1 -1 -1 -1 -1 -1 -1 -1 -1 -1 -1 -1 -1 -1 -1 -1 -1 1 0 0 3 -1 -1 -1 -1 -1 -1 -1 -1 -1 -1 -1 -1 -1 -1 -1 -1 -1 -1 -1 -1 -1 -1 -1 -1 -1 -1 -1 -1 -1 
-1 -1 -1 -1 -1 -1 -1 -1 -1 -1 -1 -1 -1 -1 -1 -1 -1 -1 -1 -1 -1 -1 -1 -1 -1 -1 -1 -1 -1 -1 -1 -1 -1 -1 -1 -1 -1 -1 -1 -1 -1 -1 -1 -1 -1 -1 -1 -1 -1 -1 -1 -1 -1 -1 -1 -1 -1 -1 -1 -1 -1 -1 -1 -1 -1 -1 -1 10 4 4 9 -1 -1 -1 -1 -1 -1 -1 -1 -1 -1 -1 -1 -1 -1 -1 -1 -1 -1 -1 -1 -1 -1 -1 -1 -1 -1 -1 -1 -1 
#Enemy: 36
1 24 29 19 31
1 24 30 20 32
1 24 32 21 33
2 23 34 34 34
2 21 36 36 36
3 17 9 7 11
0 14 13 11 14
1 4 6 3 12
1 4 7 4 13
1 4 23 14 28
1 4 24 15 27
3 2 11 7 14
3 2 25 21 29
0 4 44 39 45
2 4 47 47 47
0 9 65 62 67
1 17 48 44 55
1 17 49 45 56
1 17 50 46 57 
2 23 54 54 54
0 21 59 56 62
1 19 66 63 68
2 24 73 68 77
2 24 74 68 77
3 14 80 77 82
3 12 72 70 75
0 2 79 75 81
1 10 78 73 79
1 10 79 74 80
0 14 90 87 91
3 17 90 88 93
1 24 94 90 96
1 9 89 86 95
1 9 90 87 96
2 8 85 85 85
4 5 92 92 92

