5760 1080
7 1920
0 1 2 3 4 5 6
16 200
3 -1 -1 -1 -1 -1 -1 -1 -1 -1 -1 -1 -1 -1 -1 -1 -1 -1 -1 -1 -1 -1 -1 -1 -1 -1 -1 -1 -1 -1 -1 -1 -1 -1 -1 -1 -1 -1 -1 -1 -1 -1 -1 -1 -1 -1 -1 -1 -1 -1 -1 -1 -1 -1 -1 -1 -1 -1 -1 -1 -1 -1 -1 -1 6 -1 -1 -1 -1 -1 -1 -1 -1 -1 -1 -1 -1 -1 -1 -1 -1 -1 -1 -1 -1 -1 -1 -1 -1 -1 -1 -1 -1 -1 -1 -1 -1 -1 -1 -1 -1 -1 -1 -1 -1 -1 -1 -1 -1 -1 -1 -1 -1 -1 -1 -1 -1 -1 -1 -1 -1 -1 -1 -1 -1 -1 -1 -1 -1 -1 -1 -1 -1 -1 -1 -1 -1 -1 -1 -1 -1 -1 -1 -1 -1 -1 -1 -1 1 0 3 -1 -1 -1 -1 -1 -1 -1 -1 -1 -1 -1 -1 -1 -1 -1 -1 -1 -1 -1 -1 -1 -1 -1 -1 -1 -1 -1 -1 -1 -1 -1 -1 6 -1 -1 -1 -1 -1 -1 -1 -1 -1 -1 -1 -1 -1 -1 -1 -1 
3 -1 -1 -1 -1 -1 -1 -1 -1 -1 -1 -1 -1 -1 -1 -1 -1 -1 -1 -1 -1 -1 -1 -1 -1 -1 -1 -1 -1 -1 -1 -1 -1 -1 -1 -1 -1 -1 -1 -1 -1 -1 -1 -1 -1 -1 -1 -1 -1 5 8 8 8 8 8 8 8 8 8 12 -1 -1 -1 -1 6 -1 -1 -1 -1 -1 -1 -1 -1 -1 -1 -1 14 8 7 -1 -1 -1 -1 -1 -1 -1 -1 -1 -1 -1 -1 -1 -1 -1 -1 -1 -1 -1 -1 -1 -1 -1 -1 -1 -1 -1 -1 -1 -1 -1 -1 -1 -1 -1 -1 -1 -1 -1 -1 -1 -1 -1 -1 14 8 8 7 -1 -1 -1 -1 -1 -1 11 -1 -1 -1 -1 -1 11 -1 -1 -1 -1 -1 -1 -1 -1 1 0 9 -1 -1 -1 -1 -1 -1 -1 -1 5 7 -1 -1 -1 -1 -1 -1 -1 -1 -1 -1 -1 -1 -1 -1 -1 -1 -1 -1 -1 -1 -1 -1 6 -1 -1 -1 -1 -1 -1 -1 -1 -1 -1 -1 -1 -1 -1 -1 -1 
0 8 12 -1 -1 -1 -1 14 8 8 8 8 8 8 8 8 8 8 8 8 8 8 8 8 8 8 7 -1 -1 -1 -1 -1 14 8 8 12 -1 -1 -1 -1 -1 5 8 8 8 8 8 8 8 3 -1 -1 -1 -1 -1 -1 -1 -1 -1 -1 -1 -1 -1 -1 1 7 -1 -1 -1 -1 -1 -1 -1 -1 -1 -1 -1 -1 1 2 2 2 7 -1 -1 -1 -1 -1 15 -1 -1 -1 -1 -1 -1 -1 -1 -1 -1 -1 -1 -1 -1 15 -1 -1 -1 15 -1 -1 15 -1 -1 15 -1 -1 14 12 -1 -1 -1 -1 -1 -1 -1 -1 1 8 8 8 8 8 8 4 8 8 8 8 8 4 8 8 8 12 -1 -1 -1 -1 1 3 -1 -1 -1 -1 -1 -1 -1 -1 -1 1 0 8 7 -1 -1 -1 -1 -1 -1 -1 -1 -1 -1 -1 -1 -1 -1 -1 -1 -1 -1 -1 -1 6 -1 -1 -1 -1 -1 -1 -1 -1 -1 -1 -1 -1 -1 -1 -1 5 
3 -1 -1 -1 -1 -1 -1 -1 -1 -1 -1 -1 -1 -1 -1 -1 -1 -1 -1 -1 -1 -1 -1 -1 -1 -1 10 7 -1 -1 -1 -1 -1 -1 -1 -1 -1 -1 -1 -1 14 9 -1 -1 -1 -1 -1 -1 -1 6 -1 -1 -1 -1 -1 -1 -1 -1 -1 -1 -1 -1 -1 5 0 0 2 2 2 8 8 8 8 8 12 -1 -1 -1 1 0 0 0 3 -1 -1 -1 -1 -1 -1 -1 -1 -1 -1 -1 -1 -1 -1 -1 -1 -1 -1 -1 -1 -1 -1 15 -1 -1 -1 -1 -1 -1 -1 -1 -1 -1 -1 -1 -1 -1 14 12 -1 -1 -1 -1 6 -1 -1 -1 -1 -1 -1 -1 -1 -1 -1 -1 -1 -1 -1 -1 -1 -1 -1 -1 -1 -1 1 3 -1 -1 -1 -1 -1 -1 -1 -1 14 4 9 -1 10 8 7 -1 -1 -1 -1 -1 -1 -1 -1 -1 -1 -1 -1 -1 -1 -1 -1 -1 -1 6 -1 -1 -1 -1 -1 -1 -1 -1 -1 -1 -1 -1 -1 -1 -1 1 
3 -1 -1 -1 14 12 -1 -1 -1 -1 -1 -1 -1 -1 -1 -1 -1 -1 -1 -1 -1 -1 -1 -1 -1 -1 -1 10 8 8 8 12 -1 -1 -1 -1 14 8 8 12 -1 -1 -1 -1 -1 -1 -1 -1 -1 6 -1 -1 14 8 8 8 8 8 8 8 8 8 8 4 0 0 4 4 9 -1 -1 -1 -1 -1 -1 -1 -1 -1 1 0 0 0 0 2 7 -1 -1 -1 -1 -1 -1 -1 -1 -1 -1 -1 -1 -1 -1 -1 -1 -1 -1 15 -1 -1 -1 -1 -1 -1 -1 -1 -1 -1 -1 -1 -1 -1 -1 -1 -1 -1 -1 14 12 -1 6 -1 -1 -1 -1 -1 -1 -1 -1 -1 -1 -1 -1 -1 -1 -1 -1 -1 -1 5 2 2 4 4 8 2 2 2 2 7 -1 -1 -1 -1 -1 -1 -1 -1 6 -1 -1 -1 -1 -1 -1 -1 -1 -1 -1 -1 -1 -1 5 8 12 -1 -1 6 -1 -1 -1 -1 -1 -1 -1 -1 -1 -1 -1 -1 -1 -1 -1 1 
3 -1 -1 -1 -1 -1 -1 -1 -1 -1 -1 -1 5 2 2 2 2 2 2 17 18 2 7 -1 -1 -1 -1 -1 -1 -1 -1 -1 -1 -1 -1 -1 -1 -1 -1 -1 -1 -1 -1 -1 -1 -1 -1 -1 -1 6 -1 -1 -1 -1 -1 -1 -1 -1 -1 -1 -1 -1 -1 -1 1 9 -1 -1 -1 -1 -1 -1 -1 -1 -1 -1 14 8 0 0 0 0 0 0 3 -1 -1 -1 -1 -1 -1 -1 -1 -1 -1 -1 -1 -1 -1 -1 -1 -1 -1 -1 -1 -1 -1 -1 -1 -1 5 7 -1 -1 -1 -1 -1 -1 -1 -1 -1 -1 -1 -1 -1 -1 6 -1 -1 -1 -1 -1 14 8 8 8 12 -1 -1 -1 -1 -1 -1 -1 5 0 4 9 -1 -1 -1 10 4 4 4 4 2 8 8 8 8 12 -1 -1 1 8 8 8 8 8 8 2 2 2 2 2 8 8 9 -1 -1 -1 -1 6 -1 -1 -1 -1 -1 -1 -1 -1 -1 -1 -1 -1 -1 -1 -1 1 
0 2 7 -1 -1 15 -1 -1 -1 5 2 8 4 4 4 4 4 4 4 4 4 4 4 7 -1 -1 -1 -1 -1 -1 -1 -1 -1 -1 -1 -1 -1 -1 -1 -1 -1 -1 -1 -1 -1 -1 -1 -1 -1 1 7 -1 -1 -1 -1 -1 -1 -1 -1 -1 -1 -1 -1 -1 6 -1 -1 -1 -1 -1 11 -1 -1 -1 -1 -1 -1 -1 1 0 0 0 0 0 0 2 7 -1 -1 -1 -1 -1 15 -1 -1 -1 -1 -1 -1 -1 -1 14 8 8 8 12 -1 -1 14 8 4 4 8 12 -1 -1 -1 -1 -1 14 8 8 12 -1 -1 -1 6 -1 -1 -1 -1 -1 -1 -1 -1 -1 -1 -1 -1 -1 -1 5 2 8 4 9 -1 -1 -1 -1 -1 -1 -1 -1 -1 -1 6 -1 -1 -1 -1 -1 -1 -1 6 -1 -1 -1 -1 -1 -1 10 4 4 0 9 -1 -1 -1 -1 -1 -1 5 3 -1 -1 -1 -1 -1 -1 -1 -1 11 -1 -1 -1 -1 -1 -1 1 
0 0 0 7 -1 -1 -1 -1 5 0 9 -1 -1 -1 -1 -1 -1 -1 -1 -1 -1 -1 -1 10 7 -1 -1 -1 -1 -1 -1 -1 -1 -1 -1 -1 -1 -1 -1 -1 -1 -1 -1 -1 -1 -1 -1 -1 -1 1 4 8 8 8 8 8 8 8 8 8 8 12 -1 -1 1 2 2 2 2 2 3 -1 -1 -1 -1 -1 14 8 0 0 0 4 4 4 4 0 3 -1 -1 -1 -1 -1 -1 -1 -1 -1 -1 -1 -1 -1 -1 -1 -1 -1 -1 -1 -1 -1 -1 -1 -1 -1 -1 -1 -1 -1 15 -1 -1 -1 -1 -1 -1 -1 5 2 3 -1 -1 -1 -1 -1 -1 -1 -1 -1 -1 -1 -1 5 8 4 9 -1 -1 -1 -1 -1 -1 -1 -1 -1 -1 -1 -1 -1 10 8 7 -1 -1 -1 -1 14 9 -1 -1 -1 -1 -1 -1 -1 -1 -1 6 -1 -1 -1 -1 -1 5 2 4 9 -1 -1 -1 -1 -1 -1 -1 -1 6 -1 -1 -1 -1 -1 -1 1 
0 4 4 4 8 8 8 8 4 9 -1 -1 -1 -1 -1 -1 -1 -1 -1 -1 -1 -1 -1 -1 10 8 8 8 7 -1 -1 -1 -1 -1 -1 -1 -1 11 -1 -1 11 -1 -1 -1 14 8 8 8 2 3 -1 -1 -1 -1 -1 -1 -1 -1 -1 -1 -1 -1 -1 -1 1 0 0 0 0 0 0 7 -1 -1 -1 -1 -1 -1 1 0 9 -1 -1 -1 -1 1 0 2 7 -1 -1 -1 -1 -1 -1 -1 -1 -1 14 12 -1 -1 -1 -1 -1 -1 -1 -1 -1 -1 -1 -1 -1 -1 -1 -1 -1 -1 -1 -1 -1 -1 -1 -1 1 0 3 -1 -1 15 -1 -1 -1 -1 5 8 8 8 8 9 -1 -1 -1 -1 -1 -1 -1 -1 -1 -1 -1 -1 -1 -1 -1 -1 -1 -1 6 -1 -1 -1 -1 -1 -1 -1 11 -1 -1 -1 -1 -1 -1 5 3 -1 -1 -1 14 8 4 9 -1 -1 -1 -1 -1 -1 -1 -1 -1 -1 6 -1 -1 -1 -1 -1 -1 1 
3 -1 -1 -1 -1 -1 -1 -1 -1 -1 -1 -1 -1 -1 -1 -1 -1 -1 -1 -1 -1 -1 -1 -1 -1 -1 -1 -1 6 -1 -1 -1 -1 -1 -1 5 8 9 -1 -1 6 -1 -1 -1 -1 -1 -1 -1 10 3 -1 -1 -1 -1 -1 -1 -1 -1 -1 -1 -1 -1 -1 5 0 0 0 0 0 0 4 4 8 8 8 12 -1 -1 1 3 -1 -1 -1 -1 -1 10 4 4 0 2 7 -1 -1 15 -1 -1 -1 -1 -1 -1 -1 -1 -1 -1 -1 -1 -1 -1 -1 -1 -1 -1 -1 -1 -1 -1 -1 -1 -1 -1 -1 -1 -1 -1 10 0 3 -1 -1 -1 -1 14 8 8 9 -1 -1 -1 -1 -1 -1 -1 -1 -1 -1 -1 -1 -1 -1 -1 -1 -1 -1 -1 -1 -1 -1 -1 1 2 8 8 8 8 8 8 9 -1 -1 15 -1 -1 -1 1 4 12 -1 -1 -1 -1 -1 -1 -1 -1 -1 -1 -1 5 8 12 -1 5 9 -1 -1 -1 -1 -1 -1 1 
3 -1 -1 -1 -1 -1 -1 -1 -1 -1 -1 -1 -1 -1 -1 -1 -1 -1 -1 -1 -1 -1 -1 -1 -1 -1 -1 -1 10 8 8 8 8 8 8 9 -1 -1 -1 -1 10 8 7 -1 -1 -1 -1 -1 -1 6 -1 -1 14 8 8 8 8 8 8 8 8 8 8 4 0 0 0 0 4 9 -1 -1 -1 -1 -1 -1 -1 -1 1 3 -1 -1 -1 -1 -1 -1 -1 -1 10 0 3 -1 -1 -1 -1 -1 -1 -1 -1 -1 -1 14 8 12 -1 -1 14 8 8 12 -1 -1 14 8 7 -1 -1 -1 5 8 12 -1 -1 -1 -1 1 3 -1 -1 -1 -1 -1 -1 -1 -1 -1 -1 -1 -1 -1 -1 -1 -1 -1 -1 -1 -1 -1 -1 -1 -1 -1 -1 -1 -1 5 2 2 4 9 -1 -1 -1 -1 -1 -1 -1 -1 -1 -1 -1 -1 -1 6 -1 -1 -1 -1 -1 -1 -1 -1 -1 -1 -1 -1 5 9 -1 -1 -1 6 -1 -1 -1 -1 -1 -1 -1 1 
3 -1 -1 -1 -1 -1 -1 -1 -1 -1 -1 -1 -1 -1 -1 -1 -1 -1 -1 -1 -1 -1 -1 -1 -1 -1 -1 -1 -1 -1 -1 -1 -1 -1 -1 -1 -1 -1 -1 -1 -1 -1 10 8 8 7 -1 -1 -1 6 -1 -1 -1 -1 -1 -1 -1 -1 -1 -1 -1 -1 -1 -1 10 4 4 9 -1 -1 -1 -1 -1 -1 -1 5 2 2 0 3 -1 -1 -1 11 -1 -1 -1 -1 -1 10 4 8 7 -1 -1 -1 -1 -1 -1 -1 -1 -1 -1 -1 -1 -1 -1 -1 -1 -1 -1 -1 -1 -1 10 8 8 8 9 -1 -1 -1 -1 -1 5 0 0 2 2 12 -1 -1 -1 -1 -1 -1 -1 -1 -1 -1 -1 -1 -1 -1 -1 -1 -1 -1 -1 -1 14 8 8 8 8 4 4 9 -1 -1 -1 -1 -1 -1 -1 15 -1 15 -1 -1 15 -1 14 0 7 -1 -1 15 -1 -1 -1 -1 -1 -1 5 2 9 -1 -1 -1 5 9 -1 -1 -1 -1 -1 -1 -1 1 
3 -1 -1 -1 -1 -1 -1 -1 -1 -1 -1 -1 -1 -1 -1 5 2 17 18 2 2 2 2 2 2 7 -1 -1 -1 -1 -1 -1 -1 -1 -1 -1 -1 -1 -1 -1 -1 -1 -1 -1 -1 10 12 -1 -1 1 7 -1 -1 -1 -1 -1 -1 -1 -1 -1 -1 -1 -1 -1 -1 -1 -1 -1 -1 -1 -1 -1 -1 -1 5 0 0 0 0 3 -1 -1 5 0 7 -1 -1 -1 -1 -1 -1 -1 10 8 12 -1 -1 -1 -1 -1 -1 -1 -1 -1 -1 -1 -1 -1 -1 -1 -1 -1 -1 -1 -1 -1 -1 -1 -1 -1 -1 -1 14 8 0 0 0 0 9 -1 -1 -1 -1 -1 -1 -1 -1 5 2 2 2 2 2 7 -1 -1 -1 -1 -1 -1 -1 -1 -1 -1 -1 -1 -1 -1 -1 -1 -1 -1 -1 -1 -1 -1 -1 -1 -1 -1 -1 -1 -1 1 0 7 -1 -1 -1 -1 -1 5 8 8 4 9 -1 -1 -1 -1 13 -1 -1 -1 -1 -1 -1 -1 -1 1 
3 -1 -1 -1 -1 -1 -1 -1 -1 -1 -1 -1 5 2 2 0 0 0 0 0 0 0 0 0 0 0 2 2 2 2 7 -1 -1 -1 -1 -1 -1 -1 -1 -1 -1 -1 -1 -1 -1 -1 -1 -1 -1 1 0 2 2 7 -1 -1 -1 -1 -1 -1 -1 -1 -1 -1 -1 -1 -1 -1 -1 -1 -1 -1 -1 -1 1 0 0 0 0 3 -1 5 0 0 0 7 -1 -1 -1 -1 -1 -1 -1 -1 -1 -1 -1 -1 -1 -1 -1 -1 -1 -1 -1 -1 -1 -1 -1 -1 -1 -1 -1 -1 -1 -1 -1 -1 -1 -1 -1 -1 -1 -1 1 0 0 3 -1 -1 11 -1 -1 5 2 2 2 0 0 0 0 0 0 0 2 2 2 2 7 -1 -1 -1 -1 -1 -1 -1 -1 -1 -1 -1 -1 -1 -1 5 7 -1 -1 -1 -1 -1 -1 -1 -1 1 0 0 2 2 2 2 2 3 -1 -1 -1 -1 -1 -1 -1 -1 -1 -1 11 -1 -1 -1 -1 -1 -1 1 
0 2 2 2 2 2 2 17 18 2 2 2 0 0 0 0 0 0 0 0 0 0 0 0 0 0 0 0 0 0 0 2 2 2 19 2 2 2 2 2 2 2 2 2 2 2 2 2 2 0 0 0 0 0 2 2 2 2 2 2 2 2 2 2 2 2 2 2 2 2 2 2 17 18 0 0 0 0 0 0 2 0 0 0 0 0 2 2 2 2 2 2 2 2 2 2 2 2 2 2 2 2 2 2 2 2 2 2 2 2 2 2 2 2 2 2 2 2 2 2 2 2 2 2 0 0 0 0 2 2 0 2 2 0 0 0 0 0 0 0 0 0 0 0 0 0 0 0 0 2 2 2 2 2 2 2 2 17 16 18 2 2 2 0 0 2 2 2 2 2 2 2 2 0 0 0 0 0 0 0 0 0 2 2 2 17 16 16 16 16 16 16 18 2 2 2 2 2 2 0 
0 0 0 0 0 0 0 0 0 0 0 0 0 0 0 0 0 0 0 0 0 0 0 0 0 0 0 0 0 0 0 0 0 0 0 0 0 0 0 0 0 0 0 0 0 0 0 0 0 0 0 0 0 0 0 0 0 0 0 0 0 0 0 0 0 0 0 0 0 0 0 0 0 0 0 0 0 0 0 0 0 0 0 0 0 0 0 0 0 0 0 0 0 0 0 0 0 0 0 0 0 0 0 0 0 0 0 0 0 0 0 0 0 0 0 0 0 0 0 0 0 0 0 0 0 0 0 0 0 0 0 0 0 0 0 0 0 0 0 0 0 0 0 0 0 0 0 0 0 0 0 0 0 0 0 0 0 0 0 0 0 0 0 0 0 0 0 0 0 0 0 0 0 0 0 0 0 0 0 0 0 0 0 0 0 0 0 0 0 0 0 0 0 0 0 0 0 0 0 0 
#Enemy: 59
3 0 58 49 59
2 0 133 133 133
2 0 139 139 139
3 1 1 1 2
1 1 15 7 26
1 1 18 7 26
1 1 33 32 35
0 1 46 41 48
2 1 88 88 88
0 1 107 107 107
0 1 110 110 110
0 1 113 113 113
0 1 116 116 117
1 1 130 127 132
3 2 67 66 74
3 3 52 52 62
0 3 152 150 155
3 3 178 178 180
1 4 13 12 22
1 4 16 12 22
0 4 76 76 77
0 4 133 132 136
1 4 171 165 177
1 4 174 165 177
3 5 1 1 2
2 5 92 92 92
3 6 54 51 61
0 6 67 65 69
1 6 116 116 116
0 6 163 163 163
2 7 26 25 28
0 7 46 44 48
0 7 129 129 129
0 8 93 93 93
1 8 160 159 165
3 8 188 187 189
2 9 31 29 34
3 9 55 52 62
0 9 102 101 103
0 9 113 112 114
0 10 170 170 170
2 10 177 177 177
3 11 19 15 25
0 11 140 137 143
1 13 37 31 48
1 13 40 31 48
1 13 43 31 48
1 13 59 54 73
1 13 62 54 73
2 13 65 54 73
1 13 110 86 123
1 13 113 86 123
1 13 116 86 123
1 13 119 86 123
1 13 166 165 172
1 13 169 165 172
1 13 185 182 191
1 13 188 182 191
4 13 195 193 198
