5760 1080
7 1920
0 1 2 3 4 5 6
16 200
3 -1 -1 -1 -1 -1 -1 -1 -1 -1 -1 -1 -1 -1 -1 -1 -1 -1 -1 -1 -1 -1 -1 -1 -1 -1 -1 -1 -1 -1 -1 -1 -1 -1 -1 -1 -1 -1 -1 -1 -1 -1 -1 -1 -1 -1 -1 -1 -1 -1 -1 -1 -1 -1 -1 -1 -1 -1 -1 -1 -1 -1 -1 -1 -1 -1 -1 -1 -1 -1 -1 -1 -1 -1 -1 6 -1 -1 -1 -1 -1 -1 -1 -1 -1 -1 -1 -1 -1 -1 -1 -1 -1 -1 -1 -1 -1 -1 -1 -1 -1 -1 -1 -1 -1 -1 -1 -1 -1 -1 -1 -1 -1 -1 -1 -1 -1 -1 -1 -1 -1 -1 -1 -1 -1 -1 -1 -1 -1 -1 -1 -1 -1 -1 -1 -1 -1 -1 -1 -1 -1 -1 -1 -1 -1 -1 -1 -1 -1 -1 -1 -1 -1 -1 -1 -1 -1 -1 -1 -1 -1 -1 -1 -1 -1 -1 -1 -1 -1 -1 -1 -1 -1 -1 -1 -1 -1 -1 -1 -1 -1 -1 -1 -1 -1 -1 -1 -1 -1 -1 -1 -1 -1 -1 -1 -1 -1 -1 -1 1 
3 -1 -1 -1 -1 -1 -1 -1 -1 14 8 8 12 -1 -1 -1 -1 -1 -1 -1 -1 -1 -1 -1 -1 -1 -1 -1 -1 -1 -1 -1 -1 -1 -1 11 -1 -1 -1 -1 -1 -1 -1 -1 -1 -1 -1 -1 -1 11 -1 -1 -1 -1 -1 -1 -1 -1 -1 -1 -1 -1 11 -1 -1 -1 -1 -1 -1 -1 -1 -1 -1 -1 -1 6 -1 -1 -1 -1 -1 -1 -1 -1 -1 -1 -1 -1 -1 -1 -1 -1 -1 -1 -1 -1 -1 -1 -1 -1 -1 -1 -1 -1 -1 -1 -1 -1 -1 -1 -1 -1 -1 -1 -1 -1 -1 -1 -1 -1 -1 -1 -1 -1 -1 5 2 2 8 8 8 7 -1 -1 -1 -1 -1 -1 -1 5 8 8 8 2 7 -1 -1 -1 -1 -1 -1 -1 -1 -1 -1 -1 -1 -1 -1 -1 -1 -1 -1 -1 -1 -1 -1 -1 -1 -1 -1 -1 -1 -1 -1 -1 -1 -1 -1 -1 -1 -1 -1 -1 -1 -1 -1 -1 -1 -1 -1 -1 -1 -1 -1 -1 -1 -1 -1 1 
3 -1 -1 -1 -1 14 8 12 -1 -1 -1 -1 -1 -1 -1 -1 -1 -1 -1 -1 -1 -1 -1 -1 5 2 2 2 2 2 2 2 2 2 2 0 17 16 16 16 16 16 16 16 16 16 16 16 18 0 17 16 16 16 16 16 16 16 16 16 16 18 0 2 2 2 2 2 2 12 -1 -1 -1 -1 -1 6 -1 -1 -1 14 8 7 -1 -1 -1 -1 -1 -1 5 2 8 8 12 -1 14 8 8 12 -1 -1 -1 14 8 8 8 12 -1 -1 14 8 8 8 12 -1 -1 14 8 8 12 -1 -1 -1 -1 -1 5 0 4 9 -1 -1 -1 10 8 8 8 8 8 8 8 9 -1 -1 -1 10 4 8 8 8 8 8 8 8 8 8 8 8 2 2 7 -1 -1 -1 -1 -1 -1 -1 -1 -1 -1 -1 -1 -1 -1 -1 -1 -1 -1 -1 -1 -1 -1 -1 -1 -1 -1 -1 5 2 2 2 2 2 2 2 8 8 12 -1 -1 1 
3 -1 -1 -1 -1 -1 -1 -1 -1 -1 -1 -1 -1 14 8 8 8 8 8 12 -1 -1 14 8 4 0 0 0 4 4 4 4 4 4 4 4 4 4 4 4 4 4 4 4 4 4 4 4 4 4 4 4 4 4 4 4 4 4 4 4 4 4 4 4 4 4 4 4 9 -1 -1 -1 -1 -1 -1 6 -1 -1 -1 -1 -1 10 8 8 8 8 8 8 4 9 -1 -1 -1 -1 -1 -1 -1 -1 -1 -1 -1 -1 -1 -1 -1 -1 -1 -1 -1 -1 -1 -1 -1 -1 -1 -1 -1 -1 -1 -1 -1 -1 -1 5 0 3 -1 -1 -1 -1 -1 -1 -1 -1 -1 -1 -1 -1 -1 -1 -1 -1 -1 -1 -1 -1 -1 -1 -1 -1 -1 -1 -1 -1 -1 -1 10 4 4 2 7 -1 -1 -1 -1 -1 -1 -1 -1 -1 -1 -1 -1 -1 -1 -1 -1 -1 -1 -1 -1 -1 -1 -1 5 2 4 4 4 4 4 4 4 9 -1 -1 -1 -1 14 0 
3 -1 14 8 12 -1 -1 -1 -1 -1 -1 -1 -1 -1 -1 -1 -1 -1 -1 -1 -1 -1 -1 -1 -1 1 0 9 -1 -1 -1 -1 -1 -1 -1 -1 -1 -1 -1 -1 -1 -1 -1 -1 -1 -1 -1 -1 -1 -1 -1 -1 -1 -1 -1 -1 -1 -1 -1 -1 -1 -1 -1 -1 -1 -1 -1 -1 -1 -1 -1 -1 -1 5 2 0 7 -1 -1 -1 -1 -1 -1 -1 -1 -1 -1 -1 -1 -1 -1 -1 -1 -1 -1 -1 -1 -1 -1 -1 -1 -1 -1 -1 -1 -1 -1 -1 -1 -1 -1 -1 -1 -1 -1 -1 -1 -1 -1 -1 -1 5 2 4 0 3 -1 -1 -1 14 7 -1 -1 -1 -1 -1 -1 -1 -1 -1 -1 15 -1 -1 -1 -1 -1 -1 -1 -1 -1 -1 -1 -1 -1 -1 -1 -1 -1 10 4 8 2 7 -1 -1 -1 -1 -1 -1 -1 -1 -1 -1 -1 -1 -1 -1 -1 -1 -1 5 2 8 4 9 -1 -1 -1 -1 -1 -1 -1 -1 -1 -1 -1 -1 -1 1 
3 -1 -1 -1 -1 -1 -1 -1 -1 -1 -1 -1 -1 -1 -1 -1 -1 -1 -1 -1 -1 -1 -1 -1 -1 1 9 -1 -1 -1 -1 -1 -1 -1 -1 -1 -1 -1 -1 -1 -1 -1 -1 -1 -1 -1 -1 -1 -1 -1 -1 -1 -1 -1 -1 -1 -1 -1 -1 -1 -1 -1 -1 -1 -1 -1 -1 -1 -1 -1 5 2 2 0 0 0 0 7 -1 -1 -1 -1 -1 -1 -1 -1 -1 -1 -1 -1 -1 -1 -1 -1 -1 -1 -1 -1 -1 -1 -1 -1 -1 -1 -1 -1 -1 -1 -1 -1 -1 -1 -1 -1 -1 -1 5 2 8 8 8 4 9 -1 1 3 -1 -1 -1 -1 10 8 7 -1 -1 -1 -1 -1 5 7 -1 -1 -1 -1 14 8 8 8 7 -1 -1 -1 -1 -1 -1 -1 -1 -1 -1 -1 -1 -1 10 4 8 8 8 7 -1 -1 -1 -1 -1 -1 5 2 2 2 2 8 8 4 9 -1 -1 -1 -1 -1 -1 -1 -1 -1 -1 -1 -1 -1 -1 -1 14 0 
0 12 -1 -1 -1 -1 -1 -1 -1 -1 -1 -1 -1 -1 -1 -1 -1 -1 -1 -1 -1 -1 -1 -1 -1 6 -1 -1 -1 -1 -1 -1 -1 -1 -1 -1 -1 -1 -1 -1 -1 -1 -1 -1 -1 -1 -1 -1 -1 -1 -1 -1 -1 -1 -1 -1 -1 -1 -1 -1 -1 -1 -1 -1 -1 -1 -1 -1 5 2 0 0 0 4 4 4 4 4 8 8 7 -1 -1 -1 -1 -1 -1 -1 -1 -1 -1 -1 -1 -1 -1 -1 -1 -1 -1 -1 -1 -1 -1 -1 -1 -1 -1 -1 -1 -1 -1 -1 -1 5 2 8 4 9 -1 -1 -1 -1 -1 -1 1 0 8 12 -1 -1 -1 -1 6 -1 -1 -1 -1 -1 1 3 -1 -1 -1 -1 -1 -1 -1 -1 10 8 2 2 7 -1 -1 -1 -1 -1 -1 -1 -1 -1 -1 -1 -1 -1 -1 1 2 2 12 -1 -1 -1 1 0 0 4 9 -1 -1 -1 -1 -1 -1 -1 -1 -1 -1 -1 -1 -1 -1 -1 -1 -1 -1 -1 -1 1 
3 -1 -1 -1 -1 -1 -1 -1 -1 -1 14 8 8 8 12 -1 -1 11 -1 -1 -1 -1 -1 -1 -1 6 -1 -1 -1 -1 -1 -1 -1 -1 -1 -1 -1 -1 -1 -1 -1 -1 -1 -1 -1 -1 -1 -1 -1 -1 -1 -1 -1 -1 -1 -1 -1 -1 -1 -1 -1 -1 -1 -1 5 2 2 2 0 0 4 4 9 -1 -1 -1 -1 -1 -1 -1 10 8 8 2 7 -1 -1 -1 -1 -1 -1 -1 -1 -1 -1 -1 -1 -1 -1 -1 -1 -1 -1 -1 -1 -1 -1 -1 -1 5 2 8 8 4 9 -1 -1 -1 -1 -1 -1 -1 -1 -1 1 3 -1 -1 -1 15 -1 -1 1 7 -1 -1 -1 -1 10 0 2 12 -1 -1 -1 -1 -1 -1 -1 -1 1 0 0 2 2 8 2 7 -1 -1 -1 -1 -1 -1 -1 -1 -1 1 0 3 -1 -1 -1 -1 1 0 9 -1 -1 -1 -1 -1 -1 -1 -1 -1 -1 -1 -1 -1 -1 -1 -1 -1 -1 -1 -1 -1 14 0 
3 -1 14 8 8 8 12 -1 -1 -1 -1 -1 -1 -1 -1 -1 -1 10 8 12 -1 -1 -1 -1 -1 6 -1 -1 -1 14 8 8 8 8 8 8 8 8 8 2 7 -1 -1 -1 -1 -1 -1 -1 -1 -1 15 -1 -1 -1 -1 -1 -1 -1 5 2 8 8 8 8 4 4 4 4 4 9 -1 -1 -1 -1 -1 -1 -1 -1 -1 -1 -1 -1 -1 10 0 7 -1 -1 -1 -1 -1 -1 -1 -1 11 -1 -1 -1 -1 -1 -1 -1 -1 -1 -1 -1 5 8 8 4 9 -1 -1 -1 -1 -1 -1 -1 -1 -1 -1 -1 -1 -1 1 3 -1 -1 -1 -1 -1 -1 1 3 -1 -1 -1 -1 -1 1 9 -1 -1 -1 -1 -1 -1 -1 -1 -1 1 0 0 4 9 -1 10 4 8 8 8 12 -1 -1 -1 -1 -1 1 0 9 -1 -1 -1 -1 1 3 -1 -1 -1 -1 -1 -1 -1 -1 -1 -1 -1 -1 -1 -1 -1 -1 -1 -1 -1 -1 -1 -1 -1 1 
3 -1 -1 -1 -1 -1 -1 -1 -1 -1 -1 -1 -1 -1 -1 -1 -1 -1 -1 -1 -1 -1 -1 -1 -1 6 -1 -1 -1 -1 -1 -1 -1 -1 -1 -1 -1 -1 -1 10 4 8 7 -1 -1 -1 -1 -1 -1 -1 -1 -1 -1 -1 -1 -1 5 2 4 9 -1 -1 -1 -1 -1 -1 -1 -1 -1 -1 -1 -1 -1 -1 -1 -1 -1 -1 -1 -1 -1 -1 -1 -1 10 4 7 -1 -1 -1 -1 5 2 8 4 8 12 -1 -1 15 -1 -1 -1 14 8 8 9 -1 -1 -1 -1 -1 -1 -1 -1 -1 -1 -1 -1 -1 -1 -1 -1 -1 1 0 2 12 -1 -1 -1 14 0 3 -1 -1 -1 -1 -1 6 -1 -1 14 8 7 -1 -1 -1 -1 -1 1 0 9 -1 -1 -1 -1 -1 -1 -1 -1 -1 -1 -1 -1 5 2 4 9 -1 -1 -1 -1 -1 1 3 -1 -1 -1 -1 -1 -1 -1 -1 -1 -1 -1 -1 -1 -1 -1 -1 -1 -1 -1 -1 -1 -1 14 0 
3 -1 -1 -1 -1 -1 -1 -1 -1 -1 -1 -1 -1 -1 -1 -1 -1 -1 -1 -1 -1 15 -1 -1 -1 6 -1 -1 -1 -1 -1 -1 -1 -1 -1 -1 -1 -1 -1 -1 -1 -1 10 8 8 8 2 7 -1 -1 -1 -1 -1 5 2 8 4 9 -1 -1 -1 -1 -1 -1 -1 -1 -1 -1 -1 -1 -1 -1 -1 -1 -1 -1 -1 -1 -1 -1 -1 -1 -1 -1 -1 -1 10 8 8 8 8 4 9 -1 -1 -1 -1 -1 -1 -1 -1 -1 -1 -1 -1 -1 -1 -1 -1 -1 -1 -1 -1 -1 -1 -1 -1 -1 -1 -1 -1 -1 -1 -1 1 0 9 -1 -1 -1 -1 -1 1 0 7 -1 -1 -1 -1 6 -1 -1 -1 -1 10 8 12 -1 -1 -1 1 9 -1 -1 -1 -1 -1 -1 -1 -1 -1 -1 -1 5 8 4 9 -1 -1 -1 -1 -1 -1 -1 10 9 -1 -1 -1 -1 -1 -1 -1 -1 -1 -1 -1 -1 -1 -1 -1 -1 -1 -1 -1 -1 -1 -1 -1 1 
3 -1 -1 -1 -1 -1 -1 -1 14 8 12 -1 -1 14 8 8 7 -1 -1 -1 -1 -1 -1 -1 -1 1 7 -1 -1 -1 -1 -1 -1 -1 -1 -1 -1 -1 -1 -1 -1 -1 -1 -1 -1 -1 10 4 8 8 8 8 8 4 9 -1 -1 -1 -1 -1 -1 -1 -1 -1 -1 -1 -1 -1 -1 -1 -1 -1 -1 -1 5 2 7 -1 -1 -1 -1 -1 -1 -1 -1 -1 -1 -1 -1 -1 -1 -1 -1 -1 -1 -1 -1 -1 -1 -1 -1 -1 -1 -1 -1 -1 -1 -1 -1 -1 -1 -1 -1 -1 -1 -1 -1 -1 -1 -1 -1 -1 -1 -1 10 9 -1 -1 -1 -1 -1 5 0 0 0 12 -1 -1 -1 13 -1 -1 -1 -1 -1 -1 -1 -1 -1 -1 6 -1 -1 -1 -1 -1 14 8 8 8 8 8 8 9 -1 -1 -1 -1 -1 -1 -1 -1 -1 -1 -1 -1 -1 -1 -1 -1 -1 -1 -1 -1 -1 -1 -1 -1 -1 -1 -1 -1 -1 -1 -1 -1 -1 -1 14 0 
0 12 -1 14 8 12 -1 -1 -1 -1 -1 -1 -1 -1 -1 -1 1 7 -1 -1 -1 -1 -1 5 2 0 0 2 7 -1 -1 -1 -1 -1 -1 -1 -1 -1 -1 -1 -1 -1 -1 -1 -1 -1 -1 -1 -1 -1 -1 -1 -1 -1 -1 -1 -1 -1 -1 -1 -1 -1 -1 -1 -1 -1 -1 -1 -1 -1 5 2 2 8 0 0 0 2 7 -1 -1 -1 -1 -1 -1 -1 -1 -1 -1 -1 -1 -1 -1 -1 -1 -1 -1 -1 -1 -1 -1 -1 -1 -1 -1 -1 -1 -1 -1 -1 -1 -1 -1 -1 -1 -1 -1 -1 -1 -1 5 7 -1 -1 -1 -1 -1 -1 -1 5 2 0 0 0 9 -1 -1 -1 -1 -1 -1 -1 -1 -1 -1 -1 -1 -1 14 2 0 7 -1 -1 -1 -1 -1 -1 -1 -1 -1 -1 -1 -1 -1 -1 -1 -1 -1 -1 -1 -1 -1 -1 -1 -1 -1 -1 -1 -1 5 2 2 2 2 2 2 2 2 2 2 2 7 -1 -1 -1 -1 -1 -1 1 
3 -1 -1 -1 -1 -1 -1 -1 -1 -1 -1 -1 -1 -1 -1 -1 1 0 2 2 2 2 2 0 0 0 0 0 0 2 2 7 -1 -1 -1 -1 -1 -1 -1 -1 -1 -1 -1 -1 -1 -1 -1 -1 -1 -1 -1 -1 -1 -1 -1 -1 -1 -1 -1 -1 -1 -1 -1 -1 -1 -1 -1 -1 5 2 0 0 3 -1 1 0 0 0 0 2 2 7 -1 -1 -1 -1 -1 -1 -1 -1 -1 -1 -1 -1 -1 -1 -1 -1 -1 -1 -1 -1 -1 -1 -1 -1 5 7 -1 -1 -1 -1 -1 -1 -1 -1 -1 -1 5 2 0 0 7 -1 -1 -1 -1 -1 5 0 0 0 0 3 -1 -1 -1 -1 -1 -1 -1 -1 -1 -1 -1 -1 -1 -1 -1 1 0 0 2 7 -1 -1 -1 -1 -1 -1 -1 -1 -1 -1 -1 -1 -1 -1 -1 -1 -1 -1 -1 -1 -1 -1 -1 -1 -1 5 0 0 0 0 0 0 0 0 0 0 0 0 0 2 7 -1 -1 -1 5 0 
0 2 2 2 2 2 2 2 2 2 2 2 2 2 2 2 0 0 0 0 0 0 0 0 0 0 0 0 0 0 0 0 2 2 2 2 2 2 2 2 2 2 2 2 2 2 2 2 17 16 16 16 16 16 18 2 2 2 2 2 2 2 2 2 2 2 2 2 0 0 0 0 0 2 0 0 0 0 0 0 0 0 2 2 2 2 2 2 2 2 2 2 2 17 16 16 16 16 16 16 16 16 16 16 18 2 0 0 2 2 2 2 2 2 2 2 2 2 0 0 0 0 0 2 2 2 2 2 0 0 0 0 0 0 2 2 2 2 2 2 2 2 2 2 2 2 2 2 2 0 0 0 0 0 2 2 2 2 2 2 2 2 2 2 2 2 2 2 2 2 2 2 2 2 2 2 2 2 2 0 0 0 0 0 0 0 0 0 0 0 0 0 0 0 0 2 2 2 0 0 
0 0 0 0 0 0 0 0 0 0 0 0 0 0 0 0 0 0 0 0 0 0 0 0 0 0 0 0 0 0 0 0 0 0 0 0 0 0 0 0 0 0 0 0 0 0 0 0 0 0 0 0 0 0 0 0 0 0 0 0 0 0 0 0 0 0 0 0 0 0 0 0 0 0 0 0 0 0 0 0 0 0 0 0 0 0 0 0 0 0 0 0 0 0 0 0 0 0 0 0 0 0 0 0 0 0 0 0 0 0 0 0 0 0 0 0 0 0 0 0 0 0 0 0 0 0 0 0 0 0 0 0 0 0 0 0 0 0 0 0 0 0 0 0 0 0 0 0 0 0 0 0 0 0 0 0 0 0 0 0 0 0 0 0 0 0 0 0 0 0 0 0 0 0 0 0 0 0 0 0 0 0 0 0 0 0 0 0 0 0 0 0 0 0 0 0 0 0 0 0 
#Enemy: 72
2 0 35 35 35
2 0 49 49 49
2 0 62 62 62
1 0 141 139 144
3 1 6 5 7
0 1 29 24 34
1 1 40 36 46
1 1 42 37 47
1 1 44 38 48
2 1 46 36 48
1 1 54 50 58
1 1 56 51 59
1 1 58 52 60
1 1 60 53 61
2 1 80 79 81
0 1 90 88 92
0 1 95 94 97
0 1 103 101 105
0 1 110 108 112
0 1 116 115 118
2 1 134 132 138
3 1 148 145 158
3 1 151 145 158
3 1 186 186 196
3 1 189 186 196
2 2 15 13 19
2 2 17 13 19
3 4 146 144 148
2 4 175 174 180
2 4 177 174 180
2 5 169 168 170
2 6 12 10 14
3 6 156 153 157
1 7 4 2 6
1 7 33 29 39
1 7 35 30 40
0 7 50 50 50
3 7 59 58 63
2 7 94 94 94
4 8 99 99 99
0 8 126 126 127
2 8 143 142 144
0 10 14 13 16
1 10 50 48 52
3 10 75 74 76
3 10 158 156 162
3 11 4 3 5
0 11 183 180 192
0 11 186 180 192
0 11 189 180 192
1 12 20 18 22
1 13 8 1 15
1 13 38 32 65
1 13 40 33 66
1 13 42 34 67
2 13 44 32 67
2 13 46 32 67
1 13 59 32 67
2 13 61 32 67
1 13 91 82 103
1 13 93 83 104
1 13 95 84 105
2 13 97 82 105
0 13 114 108 117
1 13 136 134 146
1 13 138 135 147
1 13 140 136 148
1 13 162 154 176
1 13 165 155 177
1 13 167 156 178
2 13 170 154 178
2 13 172 154 178
