2560 1600
0
16 100
-1 -1 -1 -1 -1 -1 -1 -1 -1 -1 -1 -1 -1 -1 -1 -1 -1 -1 -1 -1 -1 -1 -1 -1 -1 -1 -1 -1 -1 -1 -1 -1 -1 -1 -1 -1 -1 -1 -1 -1 -1 -1 -1 -1 -1 -1 -1 -1 -1 -1 -1 -1 -1 -1 -1 -1 -1 -1 -1 -1 -1 -1 -1 -1 -1 -1 -1 -1 -1 -1 -1 -1 -1 -1 -1 -1 -1 -1 -1 -1 -1 -1 -1 -1 -1 -1 -1 -1 -1 -1 -1 -1 -1 -1 -1 -1 -1 -1 -1 -1 
-1 -1 -1 -1 -1 -1 -1 -1 -1 -1 -1 -1 -1 -1 -1 -1 -1 -1 -1 -1 -1 -1 -1 -1 -1 -1 -1 -1 -1 -1 -1 -1 -1 -1 -1 -1 -1 -1 -1 -1 -1 -1 -1 -1 -1 -1 -1 -1 -1 -1 -1 -1 -1 -1 -1 -1 -1 -1 -1 -1 -1 -1 -1 -1 -1 -1 -1 -1 -1 -1 -1 -1 -1 -1 -1 -1 -1 -1 -1 -1 -1 -1 -1 -1 -1 -1 -1 -1 -1 -1 -1 -1 -1 -1 -1 -1 -1 -1 -1 -1 
-1 -1 -1 -1 -1 -1 -1 -1 -1 -1 -1 -1 -1 -1 -1 -1 -1 -1 -1 -1 -1 -1 -1 -1 -1 -1 -1 -1 -1 -1 -1 -1 -1 -1 -1 -1 -1 -1 -1 -1 -1 -1 -1 -1 -1 -1 -1 -1 -1 -1 -1 -1 -1 -1 -1 -1 -1 -1 -1 -1 -1 -1 -1 -1 -1 -1 -1 -1 -1 -1 -1 -1 -1 -1 -1 -1 -1 -1 -1 -1 -1 -1 -1 -1 -1 -1 -1 -1 -1 -1 -1 -1 -1 -1 -1 -1 -1 -1 -1 -1 
-1 -1 -1 -1 -1 -1 -1 -1 -1 -1 -1 -1 -1 -1 -1 -1 -1 -1 -1 -1 -1 -1 -1 -1 -1 -1 -1 -1 -1 -1 -1 -1 -1 -1 -1 -1 -1 -1 -1 -1 -1 -1 -1 -1 -1 -1 -1 -1 -1 -1 -1 -1 -1 -1 -1 -1 -1 -1 -1 -1 -1 -1 -1 -1 -1 -1 -1 -1 -1 -1 -1 -1 -1 -1 -1 -1 -1 -1 -1 -1 -1 -1 -1 -1 -1 -1 -1 -1 -1 -1 -1 -1 -1 -1 -1 -1 -1 -1 -1 -1 
-1 -1 -1 -1 -1 -1 -1 -1 -1 -1 -1 -1 -1 -1 -1 -1 -1 -1 -1 -1 -1 -1 -1 -1 -1 -1 -1 -1 -1 -1 -1 -1 -1 -1 -1 -1 -1 -1 -1 -1 -1 -1 -1 -1 -1 -1 -1 -1 -1 -1 -1 -1 -1 -1 -1 -1 -1 -1 -1 -1 -1 -1 -1 -1 -1 -1 -1 -1 -1 -1 -1 -1 -1 -1 -1 -1 -1 -1 -1 -1 -1 -1 -1 -1 -1 -1 -1 -1 -1 -1 -1 -1 -1 -1 -1 -1 -1 -1 -1 -1 
-1 -1 -1 -1 -1 -1 -1 -1 -1 -1 -1 -1 -1 -1 -1 -1 -1 -1 -1 -1 -1 -1 -1 -1 -1 -1 -1 -1 15 -1 -1 -1 -1 -1 -1 15 -1 -1 -1 11 -1 -1 -1 -1 -1 -1 -1 -1 -1 -1 -1 -1 -1 -1 -1 -1 -1 15 -1 15 -1 -1 -1 -1 -1 -1 -1 15 -1 -1 -1 -1 -1 -1 -1 -1 -1 -1 -1 -1 -1 -1 -1 -1 -1 -1 15 -1 11 -1 -1 -1 -1 -1 -1 -1 -1 -1 -1 -1 
-1 -1 -1 -1 -1 15 -1 -1 -1 -1 -1 15 -1 -1 11 -1 -1 -1 -1 -1 -1 15 -1 -1 -1 11 -1 -1 -1 -1 -1 -1 -1 -1 -1 -1 -1 15 -1 10 12 -1 -1 -1 -1 -1 -1 -1 -1 11 -1 -1 -1 -1 -1 15 -1 -1 -1 -1 -1 -1 -1 -1 15 -1 -1 -1 -1 -1 14 12 -1 -1 15 -1 -1 -1 -1 -1 -1 -1 15 -1 15 -1 -1 -1 6 -1 -1 -1 -1 -1 -1 15 -1 -1 11 -1 
-1 -1 15 -1 -1 -1 -1 -1 -1 -1 -1 -1 -1 -1 13 -1 -1 -1 -1 -1 -1 -1 -1 -1 -1 6 -1 -1 -1 5 7 -1 -1 -1 -1 -1 15 -1 -1 -1 -1 -1 -1 -1 14 7 -1 11 -1 10 12 -1 -1 -1 -1 -1 -1 -1 -1 -1 -1 -1 -1 -1 -1 15 -1 -1 -1 15 -1 -1 14 7 -1 15 -1 -1 -1 -1 -1 -1 -1 -1 -1 -1 15 -1 1 7 -1 -1 15 -1 -1 -1 -1 5 9 -1 
12 -1 -1 -1 -1 14 2 2 12 -1 -1 15 -1 11 -1 -1 -1 14 12 -1 15 -1 -1 -1 14 4 7 -1 -1 1 9 -1 14 2 12 -1 -1 -1 11 -1 14 7 -1 15 -1 6 -1 10 12 -1 -1 -1 -1 11 -1 -1 -1 -1 -1 -1 -1 -1 -1 -1 -1 -1 -1 -1 15 -1 14 12 -1 13 -1 -1 -1 -1 -1 -1 11 -1 14 8 2 7 -1 -1 10 3 -1 15 -1 -1 -1 14 2 3 -1 -1 
-1 15 -1 5 12 -1 10 9 -1 -1 15 -1 -1 6 -1 -1 15 -1 -1 15 -1 -1 15 -1 -1 -1 1 2 2 3 -1 11 -1 6 -1 -1 11 -1 1 12 -1 1 12 -1 5 4 7 -1 -1 15 -1 -1 5 9 -1 -1 -1 5 7 -1 -1 5 8 7 -1 11 -1 15 -1 -1 -1 -1 -1 -1 5 2 2 2 2 8 0 7 -1 -1 1 3 -1 -1 -1 13 -1 -1 15 -1 -1 -1 1 0 7 -1 
7 -1 -1 13 -1 11 -1 -1 15 -1 -1 -1 -1 1 12 -1 -1 15 -1 -1 5 7 -1 11 -1 5 4 0 0 3 -1 1 2 0 8 8 3 -1 6 -1 -1 13 -1 -1 13 -1 1 12 -1 -1 11 -1 13 -1 14 7 -1 1 3 -1 -1 6 -1 6 -1 6 -1 -1 -1 -1 11 -1 -1 -1 1 4 0 0 3 -1 1 3 -1 -1 10 0 12 -1 11 -1 11 -1 -1 11 -1 -1 10 0 0 2 
0 2 7 -1 -1 1 2 7 -1 5 7 -1 -1 6 -1 15 -1 -1 -1 -1 1 3 -1 6 -1 6 -1 1 0 3 -1 1 4 3 -1 -1 10 8 0 7 -1 -1 -1 11 -1 -1 6 -1 5 2 0 7 -1 -1 -1 1 8 0 4 7 -1 13 -1 6 -1 1 2 7 -1 5 3 -1 -1 5 3 -1 1 0 3 -1 1 0 2 12 -1 6 -1 -1 6 -1 10 8 8 4 2 12 -1 1 0 0 
0 0 0 7 -1 1 0 0 8 0 4 8 2 0 12 -1 5 2 2 2 0 0 2 4 8 0 2 0 0 0 8 3 -1 6 -1 -1 -1 -1 1 3 -1 11 -1 1 7 -1 1 2 0 0 0 3 -1 5 2 9 -1 6 -1 1 7 -1 5 0 2 0 0 0 2 0 0 2 2 0 0 2 0 0 0 2 0 0 3 -1 -1 1 2 2 0 7 -1 -1 -1 -1 13 -1 5 0 0 0 
0 0 0 0 2 0 0 3 -1 6 -1 -1 1 3 -1 -1 1 0 4 0 0 0 3 -1 -1 1 0 0 0 3 -1 1 2 3 -1 5 2 2 0 0 2 0 2 0 0 2 0 0 0 0 4 0 2 0 3 -1 5 0 2 0 0 2 0 0 0 0 0 0 0 0 0 0 0 0 0 0 0 0 0 0 0 0 0 7 -1 1 0 0 0 0 2 2 2 7 -1 5 0 0 0 0 
0 0 0 0 0 0 0 0 2 0 2 2 0 0 2 2 0 3 -1 1 0 0 0 2 2 0 0 0 0 0 2 0 0 0 2 0 0 0 0 0 0 0 0 0 0 0 0 0 0 3 -1 1 0 0 0 2 0 0 0 0 0 0 0 0 0 0 0 0 0 0 0 0 0 0 0 0 0 0 0 0 0 0 0 0 2 0 0 0 0 0 0 0 0 0 2 0 0 0 0 0 
0 0 0 0 0 0 0 0 0 0 0 0 0 0 0 0 0 0 2 0 0 0 0 0 0 0 0 0 0 0 0 0 0 0 0 0 0 0 0 0 0 0 0 0 0 0 0 0 0 0 2 0 0 0 0 0 0 0 0 0 0 0 0 0 0 0 0 0 0 0 0 0 0 0 0 0 0 0 0 0 0 0 0 0 0 0 0 0 0 0 0 0 0 0 0 0 0 0 0 0 
