2560 1600
0
16 100
-1 -1 -1 -1 -1 -1 -1 -1 -1 -1 -1 -1 -1 -1 -1 -1 -1 -1 -1 -1 -1 -1 -1 -1 -1 -1 -1 -1 -1 -1 -1 -1 -1 -1 -1 -1 -1 -1 -1 -1 -1 -1 -1 -1 -1 -1 -1 -1 -1 -1 -1 -1 -1 -1 -1 -1 -1 -1 -1 -1 -1 -1 -1 -1 -1 -1 -1 -1 -1 -1 -1 -1 -1 -1 -1 -1 -1 -1 -1 -1 -1 -1 -1 -1 -1 -1 -1 -1 -1 -1 -1 -1 -1 -1 -1 -1 -1 -1 -1 -1 
-1 -1 -1 -1 -1 -1 -1 -1 -1 -1 -1 -1 -1 -1 -1 -1 -1 -1 -1 -1 -1 -1 -1 -1 -1 -1 -1 -1 -1 -1 -1 -1 -1 -1 -1 -1 -1 -1 -1 -1 -1 -1 -1 -1 -1 -1 -1 -1 -1 -1 -1 -1 -1 -1 -1 -1 -1 -1 -1 -1 -1 -1 -1 -1 -1 -1 -1 -1 -1 -1 -1 -1 -1 -1 -1 -1 -1 -1 -1 -1 -1 -1 -1 -1 -1 -1 -1 -1 -1 -1 -1 -1 -1 -1 -1 -1 -1 -1 -1 -1 
-1 -1 -1 -1 -1 -1 -1 -1 -1 -1 -1 -1 -1 -1 -1 -1 -1 -1 -1 -1 -1 -1 -1 -1 -1 -1 -1 -1 -1 -1 -1 -1 -1 -1 -1 -1 -1 -1 -1 -1 -1 -1 -1 -1 -1 -1 -1 -1 -1 -1 -1 -1 -1 -1 -1 -1 -1 -1 -1 -1 -1 -1 -1 -1 -1 -1 -1 -1 -1 -1 -1 -1 -1 -1 -1 -1 -1 -1 -1 -1 -1 -1 -1 -1 -1 -1 -1 -1 -1 -1 -1 -1 -1 -1 -1 -1 -1 -1 -1 -1 
-1 -1 -1 -1 -1 -1 -1 -1 -1 -1 -1 -1 -1 -1 -1 -1 -1 -1 -1 -1 -1 -1 -1 -1 -1 -1 -1 -1 -1 -1 -1 -1 -1 -1 -1 -1 -1 -1 -1 -1 -1 -1 -1 -1 -1 -1 -1 -1 -1 -1 -1 -1 -1 -1 -1 -1 -1 -1 -1 -1 -1 -1 -1 -1 -1 -1 -1 -1 -1 -1 -1 -1 -1 -1 -1 -1 -1 -1 -1 -1 -1 -1 -1 -1 -1 -1 -1 -1 -1 -1 -1 -1 -1 -1 -1 -1 -1 -1 -1 -1 
-1 -1 -1 -1 -1 -1 -1 -1 -1 -1 -1 -1 -1 -1 -1 -1 -1 -1 -1 -1 -1 -1 -1 -1 -1 -1 -1 -1 -1 -1 -1 -1 -1 -1 -1 -1 -1 -1 -1 -1 -1 -1 -1 -1 -1 -1 -1 -1 -1 -1 -1 -1 -1 -1 -1 -1 -1 -1 -1 -1 -1 -1 -1 -1 -1 -1 -1 -1 -1 -1 -1 -1 -1 -1 -1 -1 -1 -1 -1 -1 -1 -1 -1 -1 -1 -1 -1 -1 -1 -1 -1 -1 -1 -1 -1 -1 -1 -1 -1 -1 
-1 -1 -1 -1 -1 -1 -1 -1 -1 -1 -1 -1 -1 -1 -1 -1 -1 -1 -1 -1 -1 -1 -1 -1 -1 -1 -1 -1 -1 -1 -1 -1 -1 -1 -1 -1 -1 -1 -1 -1 -1 -1 -1 -1 -1 11 -1 -1 -1 -1 -1 -1 -1 -1 -1 -1 -1 -1 -1 -1 -1 -1 -1 -1 -1 -1 -1 -1 -1 -1 -1 -1 -1 -1 -1 -1 -1 -1 -1 -1 -1 -1 -1 -1 -1 -1 -1 -1 -1 -1 -1 -1 -1 -1 11 -1 -1 -1 -1 -1 
12 -1 -1 -1 -1 -1 11 -1 14 12 -1 -1 -1 -1 -1 -1 -1 -1 -1 -1 -1 -1 -1 11 -1 -1 -1 -1 -1 -1 -1 -1 -1 -1 -1 -1 -1 14 12 -1 -1 -1 -1 -1 5 0 12 -1 11 -1 -1 -1 -1 -1 -1 11 -1 14 12 -1 -1 -1 -1 -1 -1 -1 -1 -1 -1 11 -1 -1 -1 -1 -1 11 -1 -1 -1 -1 -1 -1 -1 -1 -1 -1 -1 -1 -1 -1 11 -1 14 8 0 7 -1 -1 -1 -1 
-1 11 -1 -1 -1 14 4 12 -1 -1 5 12 -1 -1 11 -1 -1 -1 5 7 -1 -1 5 0 2 7 -1 -1 -1 -1 -1 -1 -1 -1 11 -1 11 -1 -1 14 12 -1 14 8 0 3 -1 14 4 7 -1 14 12 -1 5 0 12 -1 -1 14 12 -1 -1 5 12 -1 -1 -1 5 0 7 -1 14 8 8 0 2 7 -1 -1 -1 11 -1 -1 11 -1 -1 -1 5 2 0 12 -1 -1 10 0 8 7 -1 -1 
2 0 12 -1 11 -1 -1 -1 5 2 3 -1 5 8 4 12 -1 14 4 0 8 8 0 4 4 0 7 -1 -1 -1 14 12 -1 5 0 2 0 8 12 -1 -1 11 -1 -1 10 4 7 -1 -1 1 7 -1 -1 5 0 3 -1 5 7 -1 -1 14 8 3 -1 11 -1 5 0 4 4 7 -1 -1 -1 10 0 0 7 -1 5 0 2 2 0 7 -1 14 4 0 9 -1 11 -1 -1 13 -1 10 2 2 
0 3 -1 5 0 12 -1 5 0 0 0 2 3 -1 -1 -1 11 -1 -1 6 -1 -1 6 -1 -1 1 0 7 -1 11 -1 -1 5 4 4 4 3 -1 -1 5 2 0 7 -1 -1 -1 1 2 8 0 4 8 8 0 0 4 2 0 0 2 7 -1 -1 10 2 0 2 0 3 -1 -1 1 7 -1 -1 -1 10 0 0 2 0 0 4 4 0 0 7 -1 -1 6 -1 5 0 2 12 -1 -1 -1 1 0 
0 0 2 4 3 -1 5 4 4 4 0 0 0 2 8 2 4 2 2 0 8 8 0 7 -1 1 0 0 2 0 2 2 3 -1 -1 -1 10 2 2 0 0 0 0 7 -1 5 0 3 -1 6 -1 -1 -1 1 3 -1 10 0 0 0 0 12 -1 -1 1 0 0 4 9 -1 -1 10 4 8 7 -1 -1 10 4 0 4 9 -1 -1 1 0 0 2 8 0 8 4 0 3 -1 11 -1 5 0 4 
0 0 3 -1 10 2 3 -1 -1 -1 1 0 4 9 -1 6 -1 1 0 9 -1 -1 1 0 2 0 0 0 0 0 0 0 3 -1 -1 -1 -1 1 0 0 0 4 0 0 2 0 0 3 -1 1 2 2 2 0 3 -1 -1 10 4 4 3 -1 5 2 0 0 3 -1 -1 5 7 -1 -1 -1 1 2 12 -1 -1 6 -1 -1 -1 5 4 4 0 3 -1 6 -1 -1 1 0 2 0 2 0 9 -1 
0 0 3 -1 -1 1 0 2 2 2 0 3 -1 -1 -1 6 -1 1 3 -1 5 2 0 0 0 0 0 4 4 0 0 0 0 2 2 2 2 0 0 0 3 -1 10 0 0 0 0 0 2 0 0 0 0 0 0 2 7 -1 -1 -1 1 2 0 0 0 0 0 2 2 0 0 2 7 -1 1 3 -1 5 2 0 2 2 2 3 -1 -1 1 3 -1 1 7 -1 1 0 0 0 0 3 -1 -1 
0 0 0 2 2 0 0 0 0 0 0 0 2 2 2 0 2 0 0 2 0 0 0 0 0 0 3 -1 -1 1 0 0 0 0 0 0 0 0 0 0 3 -1 -1 1 0 0 0 0 0 0 0 0 0 0 0 0 0 2 2 2 0 0 0 0 0 0 0 0 0 0 0 0 0 2 0 0 2 0 0 0 0 0 0 0 2 2 0 0 2 0 0 2 0 0 0 0 0 0 2 2 
0 0 0 0 0 0 0 0 0 0 0 0 0 0 0 0 0 0 0 0 0 0 0 0 0 0 0 2 2 0 0 0 0 0 0 0 0 0 0 0 0 2 2 0 0 0 0 0 0 0 0 0 0 0 0 0 0 0 0 0 0 0 0 0 0 0 0 0 0 0 0 0 0 0 0 0 0 0 0 0 0 0 0 0 0 0 0 0 0 0 0 0 0 0 0 0 0 0 0 0 
0 0 0 0 0 0 0 0 0 0 0 0 0 0 0 0 0 0 0 0 0 0 0 0 0 0 0 0 0 0 0 0 0 0 0 0 0 0 0 0 0 0 0 0 0 0 0 0 0 0 0 0 0 0 0 0 0 0 0 0 0 0 0 0 0 0 0 0 0 0 0 0 0 0 0 0 0 0 0 0 0 0 0 0 0 0 0 0 0 0 0 0 0 0 0 0 0 0 0 0 
