2560 1600
0
16 100
-1 -1 -1 -1 -1 -1 -1 -1 -1 -1 -1 -1 -1 -1 -1 -1 -1 -1 -1 -1 -1 -1 -1 -1 -1 -1 -1 -1 -1 -1 -1 -1 -1 -1 -1 -1 -1 -1 -1 -1 -1 -1 -1 -1 -1 -1 -1 -1 -1 -1 -1 -1 -1 -1 -1 -1 -1 -1 -1 -1 -1 -1 -1 -1 -1 -1 -1 -1 -1 -1 -1 -1 -1 -1 -1 -1 -1 -1 -1 -1 -1 -1 -1 -1 -1 -1 -1 -1 -1 -1 -1 -1 -1 -1 -1 -1 -1 -1 -1 -1 
-1 -1 -1 -1 -1 -1 -1 -1 -1 -1 -1 -1 -1 -1 -1 -1 -1 -1 -1 -1 -1 -1 -1 -1 -1 -1 -1 -1 -1 -1 -1 -1 -1 -1 -1 -1 -1 -1 -1 -1 -1 -1 -1 -1 -1 -1 -1 -1 -1 -1 -1 -1 -1 -1 -1 -1 -1 -1 -1 -1 -1 -1 -1 -1 -1 -1 -1 -1 -1 -1 -1 -1 -1 -1 -1 -1 -1 -1 -1 -1 -1 -1 -1 -1 -1 -1 -1 -1 -1 -1 -1 -1 -1 -1 -1 -1 -1 -1 -1 -1 
-1 -1 -1 -1 -1 -1 -1 -1 -1 -1 -1 -1 -1 -1 -1 -1 -1 -1 -1 -1 -1 -1 -1 -1 -1 -1 -1 -1 -1 -1 -1 -1 -1 -1 -1 -1 -1 -1 -1 -1 -1 -1 -1 -1 -1 -1 -1 -1 -1 -1 -1 -1 -1 -1 -1 -1 -1 -1 -1 -1 -1 -1 -1 -1 -1 -1 -1 -1 -1 -1 -1 -1 -1 -1 -1 -1 -1 -1 -1 -1 -1 -1 -1 -1 -1 -1 -1 -1 -1 -1 -1 -1 -1 -1 -1 -1 -1 -1 -1 -1 
-1 -1 -1 -1 -1 -1 -1 -1 -1 -1 -1 -1 -1 -1 -1 -1 -1 -1 -1 -1 -1 -1 -1 -1 -1 -1 -1 -1 -1 -1 -1 -1 -1 -1 -1 -1 -1 -1 -1 -1 -1 -1 -1 -1 -1 -1 -1 -1 -1 -1 -1 -1 -1 -1 -1 -1 -1 -1 -1 -1 -1 -1 -1 -1 -1 -1 -1 -1 -1 -1 -1 -1 -1 -1 -1 -1 -1 -1 -1 -1 -1 -1 -1 -1 -1 -1 -1 -1 -1 -1 -1 -1 -1 -1 -1 -1 -1 -1 -1 -1 
-1 -1 -1 -1 -1 -1 -1 -1 -1 -1 -1 -1 14 8 12 -1 -1 -1 -1 -1 -1 -1 -1 -1 -1 -1 -1 -1 -1 -1 -1 -1 -1 -1 -1 -1 -1 -1 -1 -1 -1 -1 -1 -1 -1 -1 -1 -1 -1 -1 -1 -1 -1 -1 -1 -1 -1 -1 -1 -1 -1 -1 -1 -1 -1 -1 -1 5 8 8 12 -1 -1 -1 -1 -1 -1 -1 -1 -1 14 8 8 8 12 -1 -1 -1 -1 -1 -1 -1 -1 -1 -1 -1 -1 -1 -1 -1 
-1 -1 -1 -1 -1 -1 -1 -1 -1 -1 15 -1 -1 -1 -1 -1 -1 -1 -1 -1 -1 -1 -1 -1 -1 -1 -1 -1 -1 -1 -1 -1 -1 -1 -1 -1 -1 -1 -1 -1 -1 -1 -1 -1 -1 11 -1 -1 -1 -1 -1 -1 -1 -1 -1 -1 -1 -1 -1 14 8 12 -1 14 8 8 8 9 -1 -1 -1 14 8 12 -1 -1 -1 -1 -1 -1 -1 -1 -1 -1 -1 -1 14 8 12 -1 -1 -1 -1 -1 -1 -1 -1 -1 -1 -1 
7 -1 -1 15 -1 -1 5 2 7 -1 -1 -1 -1 -1 -1 -1 -1 -1 -1 -1 -1 -1 -1 11 -1 -1 -1 -1 -1 -1 -1 -1 -1 -1 -1 -1 -1 5 7 -1 -1 -1 -1 -1 5 0 7 -1 -1 -1 -1 -1 -1 -1 -1 5 8 7 -1 -1 -1 -1 -1 -1 -1 -1 -1 -1 -1 -1 -1 -1 -1 -1 -1 11 -1 -1 -1 -1 -1 -1 -1 -1 -1 -1 -1 -1 -1 -1 14 12 -1 11 -1 -1 -1 -1 -1 -1 
0 7 -1 -1 -1 14 0 0 0 7 -1 -1 5 2 2 2 2 2 2 2 2 2 2 0 7 -1 -1 -1 -1 -1 -1 -1 -1 11 -1 5 2 0 4 12 -1 14 8 2 0 0 0 2 2 2 2 2 2 2 2 9 -1 13 -1 -1 -1 -1 5 7 -1 -1 -1 -1 5 2 7 -1 14 8 2 0 7 -1 -1 -1 11 -1 -1 11 -1 -1 -1 5 2 12 -1 -1 -1 10 12 -1 -1 -1 -1 5 
0 4 12 -1 -1 -1 1 0 0 3 -1 -1 10 0 0 0 0 0 0 0 0 0 4 4 4 8 12 -1 -1 5 2 2 2 0 2 0 4 9 -1 -1 -1 -1 -1 10 4 0 0 4 4 4 4 4 4 4 9 -1 -1 -1 -1 14 8 8 0 4 12 -1 -1 5 4 4 3 -1 -1 -1 10 0 0 7 -1 5 0 2 2 4 12 -1 14 4 9 -1 -1 11 -1 -1 -1 14 12 -1 -1 1 
3 -1 -1 -1 5 2 0 0 0 0 7 -1 -1 10 4 0 0 0 0 0 0 3 -1 -1 -1 -1 -1 -1 5 0 0 0 4 4 4 3 -1 -1 -1 5 2 7 -1 -1 -1 1 9 -1 -1 -1 -1 -1 -1 -1 -1 -1 14 12 -1 -1 -1 -1 13 -1 -1 -1 5 3 -1 -1 10 7 -1 -1 -1 10 0 3 -1 1 4 4 9 -1 -1 -1 -1 -1 -1 -1 5 0 2 12 -1 -1 -1 -1 5 0 
0 7 -1 5 0 0 0 0 0 0 0 7 -1 -1 -1 10 4 4 0 4 4 4 12 -1 -1 14 8 8 0 0 0 3 -1 -1 -1 13 -1 -1 14 4 4 4 7 -1 5 3 -1 -1 -1 -1 -1 -1 -1 -1 -1 -1 -1 -1 -1 5 12 -1 -1 -1 -1 5 4 9 -1 -1 -1 10 8 7 -1 -1 10 9 -1 13 -1 -1 -1 -1 -1 -1 -1 -1 -1 5 0 0 3 -1 -1 -1 -1 5 0 0 
0 3 -1 10 4 4 4 4 4 4 4 4 8 12 -1 -1 -1 -1 13 -1 -1 -1 -1 -1 -1 -1 -1 -1 10 4 4 3 -1 -1 -1 -1 -1 15 -1 -1 -1 -1 13 -1 10 9 -1 -1 -1 5 2 2 2 7 -1 -1 14 8 8 9 -1 -1 11 -1 14 9 -1 -1 -1 -1 -1 -1 -1 10 12 -1 -1 -1 -1 -1 -1 5 8 8 8 8 8 8 8 4 4 4 9 -1 -1 -1 5 0 0 0 
4 9 -1 -1 -1 -1 -1 -1 -1 -1 -1 -1 -1 -1 -1 11 -1 -1 -1 -1 -1 -1 -1 -1 -1 -1 -1 -1 -1 -1 -1 13 -1 -1 14 12 -1 -1 -1 -1 -1 -1 -1 -1 -1 -1 -1 -1 5 0 0 0 0 0 7 -1 -1 -1 -1 -1 -1 14 9 -1 -1 -1 -1 -1 5 7 -1 -1 -1 -1 -1 -1 14 8 8 8 8 9 -1 -1 -1 -1 -1 -1 -1 -1 -1 -1 -1 -1 -1 5 0 0 0 0 
-1 -1 -1 -1 -1 -1 -1 -1 -1 -1 -1 -1 -1 5 2 0 7 -1 -1 -1 5 2 2 2 2 2 2 2 2 7 -1 -1 -1 -1 -1 -1 -1 5 2 7 -1 -1 -1 -1 -1 -1 -1 5 0 0 0 0 0 0 0 2 2 2 2 7 -1 -1 -1 -1 -1 -1 -1 5 0 0 7 -1 -1 -1 11 -1 -1 -1 -1 -1 -1 -1 -1 5 2 2 7 -1 -1 -1 -1 -1 -1 -1 5 0 0 0 0 0 
-1 -1 5 2 2 2 2 2 2 2 2 2 2 0 0 0 0 2 2 2 0 0 0 0 0 0 0 0 0 0 2 2 2 2 2 2 2 0 0 0 2 2 2 2 2 2 2 0 0 0 0 0 0 0 0 0 0 0 0 0 2 2 2 2 2 2 2 0 0 0 0 2 2 2 0 2 2 2 2 2 2 2 2 0 0 0 0 2 2 2 2 2 2 2 0 0 0 0 0 0 
2 2 0 0 0 0 0 0 0 0 0 0 0 0 0 0 0 0 0 0 0 0 0 0 0 0 0 0 0 0 0 0 0 0 0 0 0 0 0 0 0 0 0 0 0 0 0 0 0 0 0 0 0 0 0 0 0 0 0 0 0 0 0 0 0 0 0 0 0 0 0 0 0 0 0 0 0 0 0 0 0 0 0 0 0 0 0 0 0 0 0 0 0 0 0 0 0 0 0 0 
